...###
..##.#.####
.##.......#
##........#
#.........#
###.......#
.#.......#.
.##......##
.#......##
.#..@..##
.#######