...........
...........
...........
...####....
...#..#....
...#@.#....
...#..#....
...####....
...........
...........
...........